1111111111
100P000001
10000000C1
10000000C1
10000000C1
10000000C1
10000000C1
100000E0C1
10000000C1
1111111111