1111111111111111111111111111111111
1P00000000011E0C00000C000000000001
1000000010000000000000010000000001
1000000000000000000000000001000001
1000010000000000000000000000000001
1000000000000000000010000000000001
1000000000000000000010000000000001
1000001000000001000000000000001001
100000000C00C0000000000000000000C1
1111111111111111111111111111111111