1111111111111111111111111111111111111111111111111111111111111111
1P000000001100C00000C0010000000001000000000000001000000100000001
100000010E010000000000110000000001000000000000001000000100000001
1000000000010000000000010001000001000000000000001000000100000001
1000100000010000000000010000000001000000000000001000000100000001
1000000000000000000100000000000001000000000000001000000000000001
1000000000000000000100010000000001000000000000000000000100000001
1000010000000010000000010000001000000000000000000000000100000001
10000000C00C00000000000100000000C0CCCCCCCCCCCCCC0CCCCCC1CCCCCCC1
1111111111111111111111111111111111111111111111111111111111111111